-.-.-.-.-.-.-.-.-.-
G.-.-.-.-.-.-.-.G.-
-.-.B.-.-.-.B.G.-.-
-.B.P.B.-.B.P.B.-.G
-.-.B.-.-.-.B.-.-.-
-.-.-.-.-.-.-.S.-.B
-.-.G.-.-.-.S.W.BS.P
-.-.-.-.-.S.-.S.-.B
-.-.-.-.S.W.BS.-.-.-
-.-.-.-.-.BS.P.B.-.A
