-.-.-.-.B.P.BS.-.G.G
-.-.-.-.-.BS.W.S.G.G
-.-.-.-.-.-.S.W.BS.B
-.-.-.-.-.-.-.BS.P.P
-.-.-.-.-.A.-.-.B.B
-.-.B.B.-.-.S.-.B.-
-.B.P.P.B.S.W.BS.P.B
-.G.B.B.S.W.S.G.BG.G
G.-.-.-.-.BS.-.G.G.G
-.-.G.-.B.P.B.G.G.G
